NO ./txt/NorthMetallic.xpm
SO ./txt/SouthMultibrickL.xpm
WE ./txt/WestWoodbrickL.xpm
EA ./txt/EastBluegreyL.xpm

F 220,100,0
C 225,30,0

        1111111111111111111111111
        1000000000110000000000001
        10110000011100000000N0001
        1001000000000000000000001
111111111011000001110000000000001
1000000000111100001110111110111111
11110111111  1011100000010001
11110111111111011101010010001
11000000110101011100000010001
10000000000000000000000010001
10000000000000001101010010001
1100000111010101111101111000111
11110111 1110101 101111010001
11111111 1111111 111111111111