NO ./txt/NorthMetallic.xpm
SO ./txt/SouthMultibrickL.xpm
WE ./txt/WestWoodbrickL.xpm
EA ./txt/EastBluegreyL.xpm

F 220,100,0
C 225,30,0


111111111111111111111111111111111111111
100000000011000000000000000001111111111
10110000011101111110000010001
10010000000000000000000010001
11110000000000000000000000111
10000000000000000000011110011
11110000000000000000000100011
11110100000000000000010010001
1100000011111101110000001000011111
100000001    10001100000010001
1000000011111100110101001000111111
11000000110101011111011110001
11110111111101011111011110001
11111111111111111111111111111