NO ./txt/NorthMetallic.xpm
SO ./txt/SouthMultibrickL.xpm
WE ./txt/WestWoodbrickL.xpm
EA ./txt/EastBluegreyL.xpm

F 220,100,0
C 225,30,0


11111111
100000001
1000N011
1000001
11100011111111
11111111