11111
1 / 1
1 W  
1   1
1   1
1       1
11111   