NO ./txt/EastBluegreyL.xpm
SO ./txt/NorthMetallic.xpm
WE ./txt/SouthMultibrickL.xpm
EA ./txt/WestWoodbrickL.xpm

F 220,100,0
C 225,30,0

11111
1   1
1 W 1
1   1
1   1
1   1
11111   